70 70 80 80 90 100 100 100 100 100 100 90 90 80 80 70 70 60 60 60 50 50 50 50 50 50 50 50 60 60 60 60 60 60 70 60 60 60 60 60 60 60 50 50 50 50 60 60 60 60
60 70 70 80 90 90 100 100 100 100 100 90 90 80 80 70 70 60 60 60 50 50 50 50 50 50 50 60 60 60 60 70 70 70 70 70 70 70 60 60 60 60 60 60 60 60 60 60 60 70
60 60 70 80 80 90 90 100 100 100 100 90 90 80 70 70 70 60 60 50 50 50 50 50 50 50 50 60 60 60 70 70 70 70 70 70 70 70 70 70 70 60 60 60 60 60 60 70 70 70
60 60 70 70 80 90 90 90 100 90 90 90 80 80 70 70 60 60 60 50 50 50 50 50 50 50 60 60 70 70 70 70 80 80 80 80 80 80 70 70 70 70 70 70 70 70 70 70 70 70
60 60 70 70 80 80 90 90 90 90 90 90 80 80 70 70 60 60 60 60 50 50 50 50 60 60 60 70 70 70 80 80 80 80 80 80 80 80 80 80 80 70 70 70 70 70 70 70 80 80
50 60 60 70 70 80 80 90 90 90 90 80 80 70 70 70 60 60 60 60 60 60 60 60 60 60 70 70 80 80 80 90 90 90 90 90 90 90 90 80 80 80 80 80 80 80 80 80 80 80
50 60 60 70 70 80 80 80 80 80 80 80 80 70 70 70 60 60 60 60 60 60 60 60 60 70 70 80 80 80 90 90 90 90 90 90 90 90 90 90 90 90 80 80 80 80 80 80 80 80
60 60 60 70 70 70 80 80 80 80 80 70 70 70 70 70 70 60 60 60 60 60 70 70 70 70 80 80 80 90 90 90 100 100 100 100 100 100 100 100 90 90 90 90 80 80 80 80 80 80
60 60 60 70 70 70 70 70 70 70 70 70 70 70 70 70 70 70 70 70 70 70 70 70 70 80 80 80 90 90 90 100 100 100 100 100 100 100 100 100 100 100 90 90 90 80 80 80 80 80
60 60 60 70 70 70 70 70 70 70 70 70 60 60 60 70 70 70 70 70 70 70 70 80 80 80 80 90 90 90 90 100 100 100 100 100 110 110 110 100 100 100 100 90 90 90 80 80 80 80
60 60 60 70 70 70 70 60 60 60 60 60 60 60 60 60 70 70 70 70 80 80 80 80 80 80 90 90 90 90 90 90 100 100 100 100 110 110 110 100 100 100 100 90 90 80 80 80 80 80
60 70 70 70 70 60 60 60 60 60 60 60 60 60 60 60 70 70 70 80 80 80 80 80 80 80 90 90 90 90 90 90 90 100 100 100 100 100 100 100 100 100 100 90 90 80 80 80 80 80
70 70 70 70 60 60 60 60 60 50 50 50 50 60 60 60 70 70 70 80 80 80 80 80 80 80 80 80 80 80 90 90 90 90 90 100 100 100 100 100 100 100 90 90 90 80 80 80 70 70
70 70 70 70 60 60 60 50 50 50 50 50 50 50 60 60 70 70 70 80 80 80 80 80 80 80 80 80 80 80 80 80 80 90 90 90 90 100 100 100 100 90 90 90 80 80 80 70 70 70
70 70 70 60 60 60 60 50 50 50 50 50 50 50 60 60 70 70 70 80 80 80 80 80 80 80 80 80 80 70 70 70 80 80 80 90 90 90 90 90 90 90 90 90 80 80 70 70 70 70
70 70 70 60 60 60 50 50 50 50 40 50 50 50 50 60 60 70 70 80 80 80 80 80 80 80 80 70 70 70 70 70 70 70 80 80 80 90 90 90 90 90 90 80 80 80 70 70 70 70
70 70 60 60 60 60 50 50 50 40 40 40 50 50 50 60 60 70 70 80 80 80 80 80 80 70 70 70 60 60 60 60 60 70 70 70 80 80 80 80 80 80 80 80 80 80 70 70 70 70
60 60 60 60 60 50 50 50 40 40 40 40 40 50 50 60 60 70 70 70 80 80 80 80 70 70 70 60 60 60 60 60 60 60 70 70 70 70 80 80 80 80 80 80 80 70 70 70 70 70
60 60 60 60 60 50 50 40 40 40 40 40 40 50 50 50 60 60 70 70 80 80 80 70 70 70 60 60 60 50 50 50 50 60 60 60 70 70 70 80 80 80 80 80 80 70 70 70 70 70
60 60 60 60 50 50 50 40 40 40 40 40 40 40 50 50 60 60 70 70 70 70 70 70 70 60 60 60 50 50 50 50 50 50 60 60 60 60 70 70 70 70 70 70 70 70 70 70 70 70
60 60 60 50 50 50 40 40 40 40 30 30 40 40 40 50 50 60 60 70 70 70 70 70 60 60 60 50 50 50 40 40 50 50 50 50 60 60 60 70 70 70 70 70 70 70 70 70 70 60
60 60 50 50 50 50 40 40 30 30 30 30 30 40 40 40 50 50 60 60 60 70 70 60 60 60 60 50 50 40 40 40 40 50 50 50 50 60 60 60 60 70 70 70 70 70 70 60 60 60
50 50 50 50 50 40 40 40 30 30 30 30 30 30 30 40 40 50 50 60 60 60 60 60 60 60 50 50 50 50 40 40 40 50 50 50 50 50 60 60 60 60 60 60 60 60 60 60 60 60
50 50 50 50 50 40 40 40 30 30 30 20 30 30 30 30 40 40 50 50 60 60 60 60 60 60 60 50 50 50 50 50 50 50 50 50 50 50 50 60 60 60 60 60 60 60 60 60 60 60
50 50 50 50 50 40 40 40 30 30 20 20 20 20 30 30 30 40 40 50 50 60 60 60 60 60 60 60 50 50 50 50 50 50 50 50 50 50 50 50 50 60 60 60 60 60 60 60 60 60
50 50 50 50 50 40 40 40 30 30 20 20 20 20 20 30 30 40 40 50 50 60 60 60 60 60 60 60 60 60 60 50 50 50 50 50 50 50 50 50 50 50 50 50 50 50 60 60 60 60
50 50 50 50 50 50 40 40 30 30 30 20 20 20 20 30 30 40 40 50 50 60 60 60 70 70 70 70 70 60 60 60 60 60 60 60 50 50 50 50 50 50 50 50 50 50 50 50 60 60
50 50 50 50 50 50 50 40 40 30 30 20 20 20 30 30 30 40 40 50 50 60 60 70 70 70 70 70 70 70 70 60 60 60 60 60 60 50 50 50 50 50 50 50 50 50 50 50 60 60
50 50 60 60 60 50 50 50 40 40 30 30 30 30 30 30 30 40 40 50 60 60 70 70 80 80 80 80 80 80 70 70 70 70 60 60 60 60 50 50 50 50 50 50 50 50 50 50 60 60
50 60 60 60 60 60 50 50 50 40 40 30 30 30 30 30 40 40 50 50 60 70 70 80 80 80 80 80 80 80 80 70 70 70 70 60 60 60 50 50 50 50 50 50 50 50 50 50 60 60
60 60 60 60 60 60 60 50 50 50 40 40 40 40 40 40 40 50 50 60 60 70 80 80 90 90 90 90 90 80 80 80 70 70 70 60 60 60 50 50 50 50 50 50 50 50 50 50 60 60
60 60 70 70 70 70 60 60 50 50 50 40 40 40 40 50 50 50 60 60 70 80 80 90 90 90 90 90 90 90 80 80 70 70 70 60 60 60 50 50 50 50 40 50 50 50 50 50 60 60
60 70 70 70 70 70 70 60 60 60 50 50 50 50 50 50 50 60 60 70 70 80 90 90 90 90 90 90 90 90 80 80 70 70 70 60 60 60 50 50 50 40 40 40 50 50 50 60 60 60
60 70 70 70 70 70 70 70 60 60 60 50 50 50 50 60 60 60 70 70 80 80 90 90 100 100 90 90 90 80 80 70 70 70 60 60 60 50 50 50 40 40 40 40 50 50 50 60 60 60
70 70 70 80 80 80 70 70 70 60 60 60 60 60 60 60 70 70 70 80 80 90 90 100 100 100 100 90 90 80 80 70 70 60 60 60 50 50 50 50 40 40 40 40 50 50 50 60 60 60
70 70 80 80 80 80 80 70 70 70 70 60 60 60 60 70 70 80 80 80 90 90 100 100 100 100 100 90 90 80 70 70 70 60 60 60 50 50 50 40 40 40 40 40 50 50 60 60 60 60
70 80 80 80 80 80 80 80 80 70 70 70 70 70 70 70 80 80 90 90 90 100 100 100 100 100 100 90 90 80 70 70 60 60 60 50 50 50 40 40 40 40 40 40 50 50 50 60 60 60
80 80 80 90 90 90 80 80 80 80 70 70 70 70 70 80 80 90 90 90 100 100 100 100 100 100 100 90 80 80 70 70 60 60 60 50 50 50 40 40 40 40 40 40 50 50 50 60 60 60
80 90 90 90 90 90 90 80 80 80 80 80 80 80 80 80 80 90 90 100 100 100 110 110 110 100 100 90 80 80 70 70 60 60 50 50 50 50 40 40 40 40 40 40 50 50 50 50 60 60
90 90 90 90 90 90 90 90 80 80 80 80 80 80 80 80 90 90 100 100 100 110 110 110 110 100 100 90 80 80 70 70 60 60 50 50 50 50 40 40 40 40 40 40 40 50 50 50 50 60
90 90 100 100 90 90 90 90 80 80 80 80 80 80 80 80 90 90 100 100 100 110 110 110 100 100 100 90 80 80 70 70 60 60 60 50 50 50 40 40 40 40 40 40 40 40 50 50 50 50
100 100 100 100 90 90 90 90 80 80 80 80 80 80 80 80 90 90 90 100 100 100 110 110 100 100 100 90 80 80 70 70 60 60 60 50 50 50 50 40 40 40 40 40 40 40 50 50 50 50
100 100 100 90 90 90 90 80 80 80 80 80 80 80 80 80 90 90 90 100 100 100 100 100 100 100 100 90 80 80 70 70 60 60 60 60 50 50 50 50 40 40 40 40 40 40 40 50 50 50
100 100 90 90 90 90 80 80 80 70 70 70 70 80 80 80 80 90 90 90 90 100 100 100 100 100 90 90 80 80 70 70 70 60 60 60 60 50 50 50 50 40 40 40 40 40 40 40 40 40
90 90 90 90 80 80 80 70 70 70 70 70 70 70 70 80 80 80 80 90 90 90 90 100 100 90 90 90 80 80 80 70 70 70 60 60 60 50 50 50 50 50 50 50 40 40 40 40 40 40
90 90 90 80 80 70 70 70 70 60 60 60 70 70 70 70 70 80 80 80 90 90 90 90 90 90 90 90 80 80 80 70 70 70 60 60 60 60 50 50 50 50 50 50 50 50 50 50 50 40
90 80 80 80 70 70 60 60 60 60 60 60 60 60 70 70 70 70 80 80 80 80 90 90 90 90 90 90 80 80 80 70 70 70 70 60 60 60 60 50 50 50 50 50 50 50 50 50 50 50
80 80 70 70 70 60 60 60 50 50 50 50 60 60 60 70 70 70 70 70 80 80 80 90 90 90 90 90 80 80 80 70 70 70 70 60 60 60 60 60 60 60 50 50 50 50 50 50 50 50
80 70 70 60 60 60 50 50 50 50 50 50 50 60 60 60 70 70 70 70 70 80 80 80 80 90 90 80 80 80 80 70 70 70 70 60 60 60 60 60 60 60 60 60 60 60 60 60 60 60
70 70 60 60 50 50 50 50 50 50 50 50 50 60 60 60 60 70 70 70 70 80 80 80 80 80 80 80 80 80 80 70 70 70 60 60 60 60 60 60 60 60 60 60 60 60 60 60 60 60
